R 1000 1000
NO ./assets/bluestone.xpm
WE ./assets/eagle.xpm
SO ./assets/mossy.xpm
EA ./assets/greystone.XPM


S ./assets/pillar.xpm
F 49,100,0
C 135,206,235

1
111
101
1001
10001
10001
1N001
100001
1000011111 
1000000001
1000200111
11111111