R 1000 700
NO ./assets/bluestone.xpm
WE ./assets/eagle.xpm
SO ./assets/mossy.xpm
EA ./assets/greystone.XPM


S ./assets/pillar.xpm
F 49,100,0
C 135,206,235

111111111111111111111111
100000000011000000000001
101100000111000000000001
102100000000000000000001
101100000111000000000001
100000000011000001110111
111101111111111111000001
111101111010101011010101
110000001101010111000001
100002000000000211000001
100000000000000211010101
110000001101010111110111
111101111111011111110111
111101111111001011000001
110000011100000011000001
120000001100000011000001
1200E0001111111011100011
120000001111111110010101
110000011100011010100011
100000001000001101010101
100000000000000000000001
120000001000001101010101
110000011100011010100011
111111111111111111111111
